1414,1414,1414,1414,1414,1414,1414,1414,1414,1414,1414,1414,1414,1414,1414,1414,1414,1414,1414,1414,1414,1414,1414,1414,1414,1414,1414,1414,1414,1414,1414,1414,1414,1414,1414,1414,1414,1414,1414,1414,1414,1414,1414,1414,1414,1414,1414,1414,1414,1414,1414,1414,1414
1414,1414,1414,1414,1414,1414,1414,1414,1414,1414,1414,1414,1414,1414,1414,1414,1414,1414,1414,1414,1414,1414,1414,1414,1414,1414,1414,1414,1414,1414,1414,1414,1414,1414,1414,1414,1414,1414,1414,1414,1414,1414,1414,1414,1414,1414,1414,1414,1414,1414,1414,1414,1414
1414,1414,1414,1414,1414,1414,1414,1414,1414,1414,1414,1414,1414,1414,1414,1414,1414,1414,1414,1414,1414,1414,1414,1414,1414,1414,1414,1414,1414,1414,1414,1414,1414,1414,1414,1414,1414,1414,1414,1414,1414,1414,1414,1414,1414,1414,1414,1414,1414,1414,1414,1414,1414
1414,1414,1414,1414,1414,1414,1414,1414,1414,1414,1414,1414,1414,1414,1414,1414,1414,1414,1414,1414,1414,1414,1414,1414,1414,1414,1414,1414,1414,1414,1414,1414,1414,1414,1414,1414,1414,1414,1414,1414,1414,1414,1414,1414,1414,1414,1414,1414,1414,1414,1414,1414,1414
1414,1414,1414,1414,1414,1414,1414,1414,1414,1414,1414,1414,1414,1414,1414,1414,1414,1414,1414,1414,1414,1414,1414,1414,1414,1414,1414,1414,1414,1414,1414,1414,1414,1414,1414,1414,1414,1414,1414,1414,1414,1414,1414,1414,1414,1414,1414,1414,1414,1414,1414,1414,1414
1414,1414,1414,1414,1414,1414,1414,1414,1414,1414,1414,1414,1414,1414,1414,1414,1414,1414,1414,1414,1414,1414,1414,1414,1414,1414,1414,1414,1414,1414,1414,1414,1414,1414,1414,1414,1414,1414,1414,1414,1414,1414,1414,1414,1414,1414,1414,1414,1414,1414,1414,1414,1414
1414,1414,1414,1414,1414,1414,1414,1414,1414,1414,1414,1414,1414,1414,1414,1414,1414,1414,1414,1414,1414,1414,1414,1414,1414,1414,1414,1414,1414,1414,1414,1414,1414,1414,1414,1414,1414,1414,1414,1414,1414,1414,1414,1414,1414,1414,1414,1414,1414,1414,1414,1414,1414
1414,1414,1414,1414,1414,1414,1414,1414,1414,1414,1414,1414,1414,1414,1414,1414,1414,1414,1414,1414,1414,1414,1414,1414,1414,1414,1414,1414,1414,1414,1414,1414,1414,1414,1414,1414,1414,1414,1414,1414,1414,1414,1414,1414,1414,1414,1414,1414,1414,1414,1414,1414,1414
1414,1414,1414,1414,1414,1414,1414,1414,1414,1414,1414,1414,1414,1414,1414,1414,1414,1414,1414,1414,1414,1414,1414,1414,1414,1414,1414,1414,1414,1414,1414,1414,1414,1414,1414,1414,1414,1414,1414,1414,1414,1414,1414,1414,1414,1414,1414,1414,1414,1414,1414,1414,1414
1414,1414,1414,1414,1414,1414,1414,1414,1414,1414,1414,1414,1414,1414,1414,1414,1414,1415,1415,1415,1415,1415,1415,1414,1414,1414,1414,1414,1414,1414,1414,1414,1414,1414,1414,1414,1414,1414,1414,1414,1414,1414,1414,1414,1414,1414,1414,1414,1414,1414,1414,1414,1414
1414,1414,1414,1414,1414,1414,1414,1414,1414,1414,1414,1414,1414,1414,1414,1414,1414,1415,1415,1415,1415,1415,1415,1414,1414,1414,1414,1414,1414,1414,1414,1414,1414,1414,1414,1414,1414,1414,1414,1414,1414,1414,1414,1414,1414,1414,1414,1414,1414,1414,1414,1414,1414
1414,1414,1414,1414,1414,1414,1414,1414,1414,1414,1414,1414,1414,1414,1414,1414,1414,1415,1415,1415,1415,1415,1415,1414,1414,1414,1414,1414,1414,1414,1414,1414,1414,1414,1414,1414,1414,1414,1414,1414,1414,1414,1414,1414,1414,1414,1414,1414,1414,1414,1414,1414,1414
1414,1414,1414,1414,1414,1414,1414,1414,1414,1414,1414,1414,1414,1414,1414,1414,1414,1415,1415,1415,1415,1414,1414,1414,1414,1414,1414,1414,1414,1414,1414,1414,1414,1414,1414,1414,1414,1414,1414,1414,1414,1414,1414,1414,1414,1414,1414,1414,1414,1414,1414,1414,1414
1414,1414,1414,1414,1414,1414,1414,1414,1414,1414,1414,1414,1414,1414,1414,1414,1415,1415,1415,1415,1415,1414,1414,1414,1414,1414,1414,1414,1414,1414,1414,1414,1414,1414,1414,1414,1414,1414,1414,1414,1414,1414,1414,1414,1414,1414,1414,1414,1414,1414,1414,1414,1414
1414,1414,1414,1414,1414,1414,1414,1414,1414,1414,1414,1414,1414,1414,1414,1414,1415,1415,1415,1415,1414,1414,1414,1414,1414,1414,1414,1414,1414,1414,1414,1414,1414,1414,1414,1414,1414,1414,1414,1414,1414,1414,1414,1414,1414,1414,1414,1414,1414,1414,1414,1414,1414
1414,1414,1414,1414,1414,1414,1414,1414,1414,1414,1414,1414,1414,1414,1414,1414,1415,1415,1415,1414,1414,1414,1414,1414,1414,1414,1414,1414,1414,1414,1414,1414,1414,1414,1414,1414,1414,1414,1414,1414,1414,1414,1414,1414,1414,1414,1414,1414,1414,1414,1414,1414,1414
1414,1414,1414,1414,1414,1414,1414,1414,1414,1414,1414,1414,1414,1414,1414,1415,1415,1415,1415,1414,1414,1414,1414,1414,1414,1414,1414,1414,1414,1414,1414,1414,1414,1414,1414,1414,1414,1414,1414,1414,1414,1414,1414,1414,1414,1414,1414,1414,1414,1414,1414,1414,1414
1414,1414,1414,1414,1414,1414,1414,1414,1414,1414,1414,1414,1414,1414,1414,1415,1415,1415,1415,1414,1414,1414,1414,1414,1414,1414,1414,1414,1414,1414,1414,1414,1414,1414,1414,1414,1414,1414,1414,1414,1414,1414,1414,1414,1414,1414,1414,1414,1414,1414,1414,1414,1414
1414,1414,1414,1414,1414,1414,1414,1414,1414,1414,1414,1414,1414,1414,1415,1415,1415,1415,1415,1414,1414,1414,1414,1414,1414,1414,1414,1414,1414,1414,1414,1414,1414,1414,1414,1414,1414,1414,1414,1414,1414,1414,1414,1414,1414,1414,1414,1414,1414,1414,1414,1414,1414
1414,1414,1414,1414,1414,1414,1414,1414,1414,1414,1414,1414,1414,1414,1415,1415,1415,1415,1415,1414,1414,1414,1414,1414,1414,1414,1414,1414,1414,1414,1414,1414,1414,1414,1414,1414,1414,1414,1414,1414,1414,1414,1414,1414,1414,1414,1414,1414,1414,1414,1414,1414,1414
1414,1414,1414,1414,1414,1414,1414,1414,1414,1414,1414,1414,1415,1415,1415,1415,1415,1415,1414,1414,1414,1414,1414,1414,1414,1414,1414,1414,1414,1414,1414,1414,1414,1414,1414,1414,1414,1414,1414,1414,1414,1414,1414,1414,1414,1414,1414,1414,1414,1414,1414,1414,1414
1414,1414,1414,1414,1414,1414,1414,1414,1414,1414,1414,1415,1415,1415,1414,1415,1415,1415,1415,1414,1414,1414,1414,1414,1414,1414,1414,1414,1414,1414,1414,1414,1414,1414,1414,1414,1414,1414,1414,1414,1414,1414,1414,1414,1414,1414,1414,1414,1414,1414,1414,1414,1414
1414,1414,1414,1414,1414,1414,1414,1414,1414,1414,1415,1415,1415,1415,1414,1415,1415,1415,1415,1414,1414,1414,1414,1414,1414,1414,1414,1414,1414,1414,1414,1414,1414,1414,1414,1414,1414,1414,1414,1414,1414,1414,1414,1414,1414,1414,1414,1414,1414,1414,1414,1414,1414
1414,1414,1414,1414,1414,1414,1414,1414,1414,1415,1415,1415,1414,1414,1414,1414,1415,1415,1415,1414,1414,1414,1414,1414,1414,1414,1414,1414,1414,1414,1414,1414,1414,1414,1414,1414,1414,1414,1414,1414,1414,1414,1414,1414,1414,1414,1414,1414,1414,1414,1414,1414,1414
1414,1414,1414,1414,1414,1414,1414,1414,1415,1415,1415,1415,1414,1414,1414,1414,1415,1415,1415,1414,1414,1414,1414,1414,1414,1414,1414,1414,1414,1414,1414,1414,1414,1414,1414,1414,1414,1414,1414,1414,1414,1414,1414,1414,1414,1414,1414,1414,1414,1414,1414,1414,1414
1414,1414,1414,1414,1414,1414,1414,1415,1415,1415,1415,1414,1414,1414,1414,1414,1415,1415,1415,1414,1414,1414,1414,1414,1414,1414,1414,1414,1414,1414,1414,1414,1414,1414,1414,1414,1414,1414,1414,1414,1414,1414,1414,1414,1414,1414,1414,1414,1414,1414,1414,1414,1414
1414,1414,1414,1414,1414,1414,1414,1415,1415,1415,1414,1414,1414,1414,1414,1414,1414,1415,1415,1414,1414,1414,1414,1414,1414,1414,1414,1414,1414,1414,1414,1414,1414,1414,1414,1414,1414,1414,1414,1414,1414,1414,1414,1414,1414,1414,1414,1414,1414,1414,1414,1414,1414
1414,1414,1414,1414,1414,1414,1415,1415,1415,1414,1414,1414,1414,1414,1414,1414,1414,1415,1415,1414,1414,1414,1414,1414,1414,1414,1414,1414,1414,1414,1414,1414,1414,1414,1414,1414,1414,1414,1414,1414,1414,1414,1414,1414,1414,1414,1414,1414,1414,1414,1414,1414,1414
1414,1414,1414,1414,1414,1414,1415,1415,1415,1414,1414,1414,1414,1414,1414,1414,1414,1415,1415,1415,1415,1414,1414,1414,1414,1414,1414,1414,1414,1414,1414,1414,1414,1414,1414,1414,1414,1414,1414,1414,1414,1414,1414,1414,1414,1414,1414,1414,1414,1414,1414,1414,1414
1414,1414,1414,1414,1414,1415,1415,1415,1414,1414,1414,1414,1414,1414,1414,1414,1414,1415,1415,1415,1415,1414,1414,1414,1414,1414,1414,1414,1414,1414,1414,1414,1414,1414,1414,1414,1414,1414,1414,1414,1414,1414,1414,1414,1414,1414,1414,1414,1414,1414,1414,1414,1414
1414,1414,1414,1414,1414,1415,1415,1415,1414,1414,1414,1414,1414,1414,1414,1414,1414,1415,1415,1415,1415,1414,1414,1414,1414,1414,1414,1414,1414,1414,1414,1414,1414,1414,1414,1414,1414,1414,1414,1414,1414,1414,1414,1414,1414,1414,1414,1414,1414,1414,1414,1414,1414
1414,1414,1414,1414,1414,1415,1415,1414,1414,1414,1414,1414,1414,1414,1414,1414,1414,1415,1415,1415,1415,1414,1414,1414,1414,1414,1414,1414,1414,1414,1414,1414,1414,1414,1414,1414,1414,1414,1414,1414,1414,1414,1414,1414,1414,1414,1414,1414,1414,1414,1414,1414,1414
1414,1414,1414,1414,1414,1415,1415,1414,1414,1414,1414,1414,1414,1414,1414,1414,1414,1414,1415,1415,1415,1414,1414,1414,1414,1414,1414,1414,1414,1414,1414,1414,1414,1414,1414,1414,1414,1414,1414,1414,1414,1414,1414,1414,1414,1414,1414,1414,1414,1414,1414,1414,1414
1414,1414,1414,1414,1415,1415,1414,1414,1414,1414,1414,1414,1414,1414,1414,1414,1414,1414,1415,1415,1415,1414,1414,1414,1414,1414,1414,1414,1414,1414,1414,1414,1414,1414,1414,1414,1414,1414,1414,1414,1414,1414,1414,1414,1414,1414,1414,1414,1414,1414,1414,1414,1414
1414,1414,1414,1414,1415,1415,1414,1414,1414,1414,1414,1414,1414,1414,1414,1414,1414,1414,1415,1415,1415,1415,1414,1414,1414,1414,1414,1414,1414,1414,1414,1414,1414,1414,1414,1414,1414,1414,1414,1414,1414,1414,1414,1414,1414,1414,1414,1414,1414,1414,1414,1414,1414
1414,1414,1414,1414,1415,1415,1414,1414,1414,1414,1414,1414,1414,1414,1414,1414,1414,1414,1415,1415,1415,1415,1414,1414,1414,1414,1414,1414,1414,1414,1414,1414,1414,1414,1414,1414,1414,1414,1414,1414,1414,1414,1414,1414,1414,1414,1414,1414,1414,1414,1414,1414,1414
1414,1414,1414,1414,1415,1415,1415,1414,1414,1414,1414,1414,1414,1414,1414,1414,1414,1414,1414,1415,1415,1415,1414,1414,1414,1414,1414,1414,1414,1414,1414,1414,1414,1414,1414,1414,1414,1414,1414,1414,1414,1414,1414,1414,1414,1414,1414,1414,1414,1414,1414,1414,1414
1414,1414,1414,1414,1415,1414,1415,1414,1414,1414,1414,1414,1414,1414,1414,1414,1414,1414,1414,1415,1415,1415,1414,1414,1414,1414,1414,1414,1414,1414,1414,1414,1414,1414,1414,1414,1414,1414,1414,1414,1414,1414,1414,1414,1414,1414,1414,1414,1414,1414,1414,1414,1414
1414,1414,1414,1414,1415,1414,1415,1414,1414,1414,1414,1414,1414,1414,1414,1414,1414,1414,1414,1415,1415,1415,1414,1414,1414,1414,1414,1414,1414,1414,1414,1414,1414,1414,1414,1414,1414,1414,1414,1414,1414,1414,1414,1414,1414,1414,1414,1414,1414,1414,1414,1414,1414
1414,1414,1414,1414,1415,1414,1415,1414,1414,1414,1414,1414,1414,1414,1414,1414,1414,1414,1414,1415,1415,1415,1414,1414,1414,1414,1414,1414,1414,1414,1414,1414,1414,1414,1414,1414,1414,1414,1414,1414,1414,1414,1414,1414,1414,1414,1414,1414,1414,1414,1414,1414,1414
1414,1414,1414,1414,1414,1414,1415,1414,1414,1414,1415,1415,1415,1414,1414,1414,1414,1414,1414,1414,1414,1414,1414,1414,1414,1414,1414,1414,1414,1414,1414,1414,1414,1414,1414,1414,1414,1414,1414,1414,1414,1414,1414,1414,1414,1414,1414,1414,1414,1414,1414,1414,1414
1414,1414,1414,1414,1415,1414,1415,1415,1414,1414,1414,1415,1414,1414,1414,1414,1414,1414,1414,1415,1415,1415,1415,1414,1414,1414,1414,1414,1414,1414,1414,1414,1414,1414,1414,1414,1414,1414,1414,1414,1414,1414,1414,1414,1414,1414,1414,1414,1414,1414,1414,1414,1414
1414,1414,1414,1414,1415,1414,1415,1415,1414,1414,1414,1414,1414,1414,1414,1414,1414,1414,1414,1415,1415,1415,1415,1414,1414,1414,1414,1414,1414,1414,1414,1414,1414,1414,1414,1414,1414,1414,1414,1414,1414,1414,1414,1414,1414,1414,1414,1414,1414,1414,1414,1414,1414
1414,1414,1414,1414,1415,1414,1415,1414,1414,1414,1414,1414,1414,1414,1414,1414,1414,1414,1414,1415,1415,1415,1415,1414,1414,1414,1414,1414,1414,1414,1414,1414,1414,1414,1414,1414,1414,1414,1414,1414,1414,1414,1414,1414,1414,1414,1414,1414,1414,1414,1414,1414,1414
1414,1414,1414,1414,1415,1414,1415,1414,1414,1414,1414,1414,1414,1414,1414,1414,1414,1414,1414,1415,1415,1415,1415,1414,1414,1414,1414,1414,1414,1414,1414,1414,1414,1414,1414,1414,1414,1414,1414,1414,1414,1414,1414,1414,1414,1414,1414,1414,1414,1414,1414,1414,1414
1414,1414,1414,1414,1415,1414,1414,1414,1414,1414,1414,1414,1414,1414,1414,1414,1414,1414,1414,1415,1415,1415,1415,1414,1414,1414,1414,1414,1414,1414,1414,1414,1414,1414,1414,1414,1414,1414,1414,1414,1414,1414,1414,1414,1414,1414,1414,1414,1414,1414,1414,1414,1414
1414,1414,1414,1415,1415,1414,1414,1414,1414,1414,1414,1414,1414,1414,1414,1414,1414,1414,1414,1415,1415,1415,1415,1414,1414,1414,1414,1414,1414,1414,1414,1414,1414,1414,1414,1414,1414,1414,1414,1414,1414,1414,1414,1414,1414,1414,1414,1414,1414,1414,1414,1414,1414
1414,1414,1414,1415,1415,1414,1414,1414,1414,1414,1414,1414,1414,1414,1414,1414,1414,1414,1414,1415,1415,1415,1415,1414,1414,1414,1414,1414,1414,1414,1414,1414,1414,1414,1414,1414,1414,1414,1414,1414,1414,1414,1414,1414,1414,1414,1414,1414,1414,1414,1414,1414,1414
1414,1414,1414,1415,1415,1414,1414,1414,1414,1414,1414,1414,1414,1414,1414,1414,1414,1414,1414,1414,1415,1415,1415,1414,1414,1414,1414,1414,1414,1414,1414,1414,1414,1414,1414,1414,1414,1414,1414,1414,1414,1414,1414,1414,1414,1414,1414,1414,1414,1414,1414,1414,1414
1414,1414,1414,1415,1414,1414,1414,1414,1414,1414,1414,1414,1414,1414,1414,1414,1414,1414,1414,1414,1415,1415,1415,1414,1414,1414,1414,1414,1414,1414,1414,1414,1414,1414,1414,1414,1414,1414,1414,1414,1414,1414,1414,1414,1414,1414,1414,1414,1414,1414,1414,1414,1414
1414,1414,1414,1415,1414,1414,1414,1414,1414,1414,1414,1414,1415,1414,1414,1414,1414,1414,1414,1414,1415,1415,1415,1414,1414,1414,1414,1414,1414,1414,1414,1414,1414,1414,1414,1414,1414,1414,1414,1414,1414,1414,1414,1414,1414,1414,1414,1414,1414,1414,1414,1414,1414
1414,1414,1415,1415,1414,1414,1414,1414,1414,1414,1414,1414,1414,1414,1414,1414,1414,1414,1414,1414,1415,1415,1415,1414,1414,1414,1414,1414,1414,1414,1414,1414,1414,1414,1414,1414,1414,1414,1414,1414,1414,1414,1414,1414,1414,1414,1414,1414,1414,1414,1414,1414,1414
1414,1414,1415,1414,1414,1414,1414,1414,1414,1414,1414,1414,1414,1414,1414,1414,1414,1414,1414,1414,1414,1415,1415,1414,1414,1414,1414,1414,1414,1414,1414,1414,1414,1414,1414,1414,1414,1414,1414,1414,1414,1414,1414,1414,1414,1414,1414,1414,1414,1414,1414,1414,1414
1414,1414,1415,1414,1414,1414,1415,1415,1415,1414,1414,1414,1414,1414,1414,1414,1414,1414,1414,1414,1414,1415,1415,1415,1414,1414,1414,1414,1414,1414,1414,1414,1414,1414,1414,1414,1414,1414,1414,1414,1414,1414,1414,1414,1414,1414,1414,1414,1414,1414,1414,1414,1414
1414,1415,1415,1414,1414,1414,1414,1414,1414,1414,1414,1414,1414,1414,1414,1414,1414,1414,1414,1414,1414,1415,1415,1415,1414,1414,1414,1414,1414,1414,1414,1414,1414,1414,1414,1414,1414,1414,1414,1414,1414,1414,1414,1414,1414,1414,1414,1414,1414,1414,1414,1414,1414
1414,1415,1415,1414,1414,1414,1414,1414,1414,1414,1414,1414,1414,1414,1414,1414,1414,1414,1414,1414,1414,1415,1415,1415,1414,1414,1414,1414,1414,1414,1414,1414,1414,1414,1414,1414,1414,1414,1414,1414,1414,1414,1414,1414,1414,1414,1414,1414,1414,1414,1414,1414,1414
1415,1415,1414,1414,1414,1414,1414,1415,1414,1414,1414,1414,1414,1414,1414,1414,1414,1414,1414,1414,1414,1415,1415,1415,1414,1414,1414,1414,1414,1414,1414,1414,1414,1414,1414,1414,1414,1414,1414,1414,1414,1414,1414,1414,1414,1414,1414,1414,1414,1414,1414,1414,1414
1415,1414,1414,1414,1414,1414,1414,1414,1414,1414,1414,1415,1415,1415,1414,1414,1414,1414,1414,1414,1414,1415,1415,1415,1414,1414,1414,1414,1414,1414,1414,1414,1414,1414,1414,1414,1414,1414,1414,1414,1414,1414,1414,1414,1414,1414,1414,1414,1414,1414,1414,1414,1414
1415,1414,1414,1414,1414,1414,1414,1414,1414,1414,1414,1414,1415,1414,1414,1414,1414,1414,1414,1414,1414,1415,1415,1415,1415,1414,1414,1414,1414,1414,1414,1414,1414,1414,1414,1414,1414,1414,1414,1414,1414,1414,1414,1414,1414,1414,1414,1414,1414,1414,1414,1414,1414
1414,1414,1414,1414,1414,1414,1414,1414,1414,1414,1414,1414,1414,1414,1414,1414,1414,1414,1414,1414,1414,1415,1415,1415,1415,1414,1414,1414,1414,1414,1414,1414,1414,1414,1414,1414,1414,1414,1414,1414,1414,1414,1414,1414,1414,1414,1414,1414,1414,1414,1414,1414,1414
1414,1414,1414,1414,1414,1414,1414,1414,1414,1414,1414,1414,1414,1414,1414,1414,1414,1414,1414,1414,1414,1414,1415,1415,1415,1414,1414,1414,1414,1414,1414,1414,1414,1414,1414,1414,1414,1414,1414,1414,1414,1414,1414,1414,1414,1414,1414,1414,1414,1414,1414,1414,1414
1414,1414,1414,1414,1414,1414,1414,1414,1414,1414,1414,1414,1414,1414,1414,1414,1414,1414,1414,1414,1414,1414,1415,1415,1415,1414,1414,1414,1414,1414,1414,1414,1414,1414,1414,1414,1414,1414,1414,1414,1414,1414,1414,1414,1414,1414,1414,1414,1414,1414,1414,1414,1414
1414,1414,1414,1414,1414,1414,1415,1415,1415,1414,1414,1414,1414,1414,1414,1414,1414,1414,1414,1414,1414,1414,1415,1415,1415,1415,1414,1414,1414,1414,1414,1414,1414,1414,1414,1414,1414,1414,1414,1414,1414,1414,1414,1414,1414,1414,1414,1414,1414,1414,1414,1414,1414
1414,1414,1414,1414,1414,1414,1414,1415,1414,1414,1414,1414,1414,1414,1414,1414,1414,1414,1414,1414,1414,1414,1415,1415,1415,1415,1414,1414,1414,1414,1414,1414,1414,1414,1414,1414,1414,1414,1414,1414,1414,1414,1414,1414,1414,1414,1414,1414,1414,1415,1415,1415,1414
1414,1414,1415,1414,1414,1414,1414,1414,1414,1414,1414,1414,1414,1414,1414,1414,1414,1414,1414,1414,1414,1414,1415,1415,1415,1415,1414,1414,1414,1414,1414,1414,1414,1414,1414,1414,1414,1414,1414,1414,1414,1414,1414,1414,1414,1414,1414,1414,1414,1415,1415,1415,1414
1414,1414,1414,1414,1414,1414,1414,1414,1414,1414,1414,1414,1414,1414,1414,1414,1414,1414,1414,1414,1414,1414,1415,1415,1415,1415,1414,1414,1414,1414,1414,1414,1414,1414,1414,1414,1414,1414,1414,1414,1414,1414,1414,1414,1414,1414,1414,1414,1414,1415,1415,1415,1414
1414,1414,1414,1414,1414,1414,1414,1414,1414,1414,1415,1414,1414,1414,1414,1414,1414,1414,1414,1414,1414,1414,1415,1415,1415,1415,1414,1414,1414,1414,1414,1414,1414,1414,1414,1414,1414,1414,1414,1414,1414,1414,1414,1414,1414,1414,1414,1414,1414,1415,1415,1415,1414
1414,1414,1414,1414,1414,1414,1414,1414,1414,1414,1414,1414,1414,1414,1414,1414,1414,1414,1414,1414,1414,1414,1415,1415,1415,1415,1414,1414,1414,1414,1414,1414,1414,1414,1414,1414,1414,1414,1414,1414,1414,1414,1414,1414,1414,1414,1414,1414,1414,1415,1415,1415,1414
1415,1414,1414,1414,1414,1414,1414,1414,1414,1414,1414,1414,1414,1414,1414,1414,1414,1414,1414,1414,1414,1414,1414,1415,1415,1415,1415,1414,1414,1414,1414,1414,1414,1414,1414,1414,1414,1414,1414,1414,1414,1414,1414,1414,1414,1414,1414,1414,1414,1414,1414,1414,1414
1414,1414,1414,1414,1414,1414,1414,1414,1414,1414,1414,1414,1414,1414,1414,1414,1414,1414,1414,1414,1414,1414,1414,1414,1415,1415,1415,1415,1414,1414,1414,1414,1414,1414,1414,1414,1414,1414,1414,1414,1414,1414,1414,1415,1415,1414,1414,1414,1414,1414,1414,1414,1414
1414,1414,1414,1414,1414,1415,1415,1415,1414,1414,1414,1414,1414,1414,1414,1414,1414,1414,1414,1414,1414,1414,1414,1414,1415,1415,1415,1415,1414,1414,1414,1414,1415,1415,1415,1414,1414,1414,1414,1414,1414,1415,1415,1415,1414,1414,1414,1414,1414,1414,1414,1414,1414
1414,1414,1414,1414,1414,1414,1415,1414,1414,1414,1414,1414,1414,1414,1415,1414,1415,1414,1414,1414,1414,1414,1414,1414,1415,1415,1415,1415,1414,1414,1414,1414,1414,1415,1414,1414,1414,1414,1414,1414,1414,1414,1414,1414,1414,1414,1414,1414,1414,1414,1414,1414,1414
1414,1414,1414,1414,1414,1414,1414,1414,1414,1414,1414,1414,1414,1414,1414,1414,1414,1414,1414,1414,1414,1414,1414,1414,1415,1415,1415,1415,1415,1414,1414,1414,1414,1414,1414,1414,1414,1414,1414,1414,1414,1414,1414,1414,1414,1414,1414,1414,1414,1414,1414,1414,1414
1414,1414,1414,1414,1414,1414,1415,1414,1414,1414,1414,1414,1414,1414,1414,1414,1414,1414,1414,1414,1414,1414,1414,1414,1415,1415,1415,1415,1415,1414,1414,1414,1414,1414,1414,1414,1414,1414,1414,1414,1414,1414,1414,1414,1414,1414,1414,1414,1414,1414,1414,1414,1414
1414,1415,1415,1415,1414,1414,1414,1414,1414,1414,1414,1414,1414,1414,1414,1414,1414,1414,1414,1414,1414,1414,1414,1414,1414,1415,1415,1415,1415,1415,1414,1414,1414,1414,1414,1414,1414,1414,1414,1414,1414,1414,1414,1414,1414,1414,1414,1414,1415,1415,1415,1414,1414
1414,1414,1414,1414,1414,1414,1414,1414,1414,1414,1414,1414,1414,1414,1414,1414,1414,1414,1414,1414,1414,1414,1414,1414,1414,1415,1415,1415,1415,1415,1414,1414,1414,1414,1414,1414,1415,1415,1415,1414,1414,1414,1415,1415,1415,1414,1414,1414,1414,1415,1414,1414,1414
1414,1414,1414,1414,1414,1414,1414,1414,1414,1414,1414,1414,1414,1414,1414,1414,1414,1414,1414,1414,1414,1414,1414,1414,1414,1415,1415,1415,1415,1415,1415,1414,1414,1414,1414,1414,1414,1415,1414,1414,1414,1414,1414,1415,1414,1414,1414,1414,1414,1414,1414,1414,1414
1415,1415,1415,1415,1415,1415,1415,1415,1415,1415,1414,1414,1414,1415,1415,1415,1415,1415,1415,1415,1415,1415,1415,1415,1415,1415,1415,1415,1415,1415,1415,1414,1414,1414,1414,1414,1414,1414,1414,1414,1414,1414,1414,1414,1414,1414,1414,1414,1414,1414,1414,1414,1414
1414,1414,1414,1414,1414,1414,1414,1414,1414,1414,1414,1414,1414,1414,1414,1414,1414,1414,1414,1414,1414,1414,1414,1414,1414,1415,1415,1415,1415,1415,1415,1414,1414,1414,1414,1414,1414,1414,1414,1414,1414,1414,1414,1414,1414,1414,1414,1414,1414,1414,1414,1414,1414
1414,1414,1414,1414,1414,1414,1414,1414,1414,1414,1414,1414,1414,1414,1414,1415,1415,1415,1414,1414,1414,1414,1414,1414,1414,1415,1415,1415,1415,1415,1415,1415,1415,1414,1414,1414,1414,1414,1414,1415,1415,1415,1414,1414,1414,1414,1414,1414,1414,1414,1414,1414,1414
1414,1414,1414,1414,1414,1414,1414,1414,1414,1414,1414,1414,1414,1414,1414,1414,1415,1414,1414,1414,1414,1414,1414,1414,1414,1414,1415,1415,1415,1415,1415,1415,1415,1415,1415,1414,1414,1414,1414,1414,1415,1414,1414,1414,1414,1414,1414,1414,1414,1415,1415,1415,1414
1414,1414,1415,1415,1415,1414,1414,1414,1414,1414,1414,1414,1414,1414,1414,1414,1414,1414,1414,1414,1414,1414,1414,1414,1414,1414,1415,1415,1415,1415,1415,1415,1415,1415,1415,1415,1414,1414,1414,1414,1414,1414,1414,1414,1414,1414,1414,1414,1414,1414,1415,1414,1414
1414,1414,1414,1415,1414,1414,1414,1414,1414,1414,1414,1414,1414,1414,1414,1414,1414,1414,1414,1414,1414,1414,1414,1414,1414,1414,1414,1415,1415,1415,1415,1415,1415,1415,1415,1415,1414,1414,1414,1414,1414,1414,1414,1414,1415,1415,1415,1414,1414,1414,1414,1414,1414
1414,1414,1414,1414,1414,1414,1414,1414,1415,1414,1414,1414,1414,1414,1414,1414,1414,1414,1414,1414,1414,1414,1414,1414,1414,1414,1414,1414,1415,1415,1415,1415,1415,1415,1415,1415,1415,1414,1414,1414,1414,1414,1414,1414,1414,1415,1414,1414,1414,1414,1414,1414,1414
1414,1414,1414,1414,1414,1414,1414,1414,1414,1414,1414,1414,1414,1414,1414,1414,1414,1414,1414,1414,1414,1414,1414,1414,1414,1414,1414,1414,1415,1415,1415,1415,1415,1415,1415,1415,1415,1415,1414,1414,1414,1415,1415,1415,1414,1414,1414,1414,1414,1414,1414,1414,1414
1414,1414,1414,1414,1414,1414,1414,1414,1414,1414,1414,1414,1414,1414,1414,1414,1414,1414,1414,1414,1414,1414,1414,1414,1414,1414,1414,1414,1415,1415,1415,1415,1415,1415,1415,1415,1415,1415,1414,1414,1414,1414,1415,1414,1414,1414,1414,1415,1415,1415,1414,1414,1414
1414,1414,1414,1414,1414,1414,1414,1414,1414,1414,1414,1414,1414,1414,1414,1414,1414,1415,1414,1414,1414,1414,1414,1414,1414,1414,1414,1414,1415,1415,1415,1415,1415,1415,1415,1415,1415,1415,1415,1414,1414,1414,1414,1414,1414,1414,1414,1414,1415,1414,1414,1415,1415
1414,1414,1414,1414,1414,1414,1414,1414,1414,1414,1414,1414,1414,1414,1414,1414,1414,1414,1414,1414,1414,1414,1414,1414,1414,1414,1414,1414,1414,1415,1415,1415,1415,1415,1415,1415,1415,1415,1415,1414,1414,1414,1414,1414,1414,1414,1414,1414,1414,1414,1414,1414,1415
1414,1414,1414,1414,1414,1414,1414,1414,1414,1414,1414,1414,1414,1414,1414,1414,1414,1414,1414,1414,1414,1414,1414,1414,1414,1414,1414,1414,1414,1414,1415,1415,1415,1415,1415,1415,1415,1415,1415,1414,1414,1414,1414,1414,1414,1414,1414,1414,1414,1414,1414,1414,1414
1414,1414,1414,1414,1414,1414,1414,1414,1414,1414,1414,1414,1414,1414,1414,1414,1414,1414,1414,1414,1414,1415,1415,1415,1414,1414,1414,1414,1414,1414,1414,1415,1415,1415,1415,1415,1415,1415,1415,1415,1414,1414,1414,1414,1414,1414,1414,1414,1414,1414,1414,1414,1414
1414,1414,1414,1414,1414,1414,1414,1414,1414,1414,1414,1415,1415,1415,1414,1414,1414,1414,1414,1414,1414,1414,1414,1414,1414,1414,1414,1414,1414,1414,1414,1414,1415,1415,1415,1415,1415,1415,1415,1415,1414,1414,1414,1414,1415,1415,1415,1414,1414,1414,1414,1414,1414
1414,1414,1414,1414,1414,1414,1414,1414,1414,1414,1414,1414,1415,1414,1414,1414,1414,1414,1414,1414,1414,1414,1414,1414,1414,1414,1414,1414,1414,1414,1414,1414,1414,1415,1415,1415,1415,1415,1415,1415,1414,1414,1414,1414,1414,1415,1414,1414,1414,1414,1414,1414,1414
1414,1414,1414,1414,1414,1414,1414,1414,1414,1414,1414,1414,1414,1414,1414,1414,1414,1414,1414,1414,1414,1414,1414,1414,1414,1414,1414,1414,1414,1414,1414,1414,1414,1415,1415,1415,1415,1415,1415,1415,1415,1414,1414,1414,1414,1414,1414,1414,1414,1415,1415,1415,1414
1414,1414,1414,1414,1414,1414,1414,1414,1414,1414,1414,1414,1414,1414,1414,1414,1414,1414,1414,1414,1414,1414,1414,1414,1414,1414,1414,1414,1414,1414,1414,1414,1414,1414,1415,1415,1415,1415,1415,1415,1415,1414,1414,1414,1414,1414,1414,1414,1414,1414,1415,1414,1414
1414,1414,1415,1414,1414,1414,1414,1414,1414,1414,1414,1414,1414,1414,1414,1414,1414,1414,1414,1414,1414,1414,1414,1414,1414,1414,1414,1414,1414,1414,1414,1414,1414,1414,1414,1415,1415,1415,1415,1415,1415,1414,1414,1414,1414,1414,1414,1414,1414,1414,1414,1414,1414
1414,1414,1414,1414,1414,1414,1414,1414,1414,1414,1414,1414,1414,1414,1414,1414,1414,1414,1414,1415,1415,1415,1414,1414,1414,1414,1414,1414,1414,1414,1414,1414,1414,1414,1414,1415,1415,1415,1415,1415,1415,1415,1414,1414,1414,1414,1414,1414,1414,1414,1414,1414,1414
1414,1414,1414,1414,1414,1414,1414,1414,1414,1414,1414,1414,1414,1414,1414,1414,1414,1414,1414,1414,1415,1414,1414,1414,1414,1414,1414,1414,1414,1414,1414,1414,1414,1414,1414,1415,1415,1415,1415,1415,1415,1415,1414,1414,1414,1414,1414,1414,1414,1414,1414,1414,1414
1414,1414,1414,1414,1414,1414,1414,1414,1414,1414,1414,1414,1414,1414,1414,1414,1414,1414,1414,1414,1414,1414,1414,1414,1414,1414,1414,1414,1414,1414,1414,1414,1414,1414,1414,1414,1415,1415,1415,1415,1415,1415,1414,1414,1414,1414,1414,1414,1414,1414,1414,1414,1414
1414,1414,1414,1414,1414,1414,1414,1414,1414,1414,1414,1414,1414,1414,1414,1414,1414,1414,1414,1414,1414,1414,1414,1414,1414,1414,1414,1414,1414,1414,1414,1414,1414,1414,1414,1414,1415,1415,1415,1415,1415,1415,1415,1414,1414,1414,1414,1414,1414,1414,1414,1414,1414
1414,1414,1414,1414,1414,1414,1414,1414,1414,1414,1414,1414,1414,1414,1414,1414,1414,1414,1414,1415,1415,1415,1415,1415,1415,1415,1415,1415,1415,1415,1415,1415,1414,1414,1414,1414,1415,1415,1415,1415,1415,1415,1415,1415,1415,1415,1415,1415,1415,1415,1415,1415,1415
