1415,1415,1415,1415,1415,1415,1415,1415,1415,1415,1415,1415,1415,1415,1415,1415,1415,1415,1415,1415,1415,1415,1415,1415,1415,1415,1415,1414,1414,1414,1414,1414,1414,1414,1414,1414,1414,1414,1414,1414,1414,1414,1414,1414,1414,1414,1414,1414,1414,1414,1414,1414,1414
1415,1415,1415,1415,1415,1415,1415,1415,1415,1415,1415,1415,1415,1415,1415,1415,1415,1414,1415,1415,1415,1415,1415,1414,1415,1415,1415,1414,1414,1414,1414,1414,1414,1414,1414,1414,1414,1414,1414,1414,1414,1414,1414,1414,1414,1414,1414,1414,1414,1414,1414,1414,1414
1415,1415,1415,1415,1415,1415,1415,1415,1415,1415,1415,1415,1414,1415,1415,1415,1415,1415,1415,1415,1415,1415,1415,1415,1415,1415,1415,1415,1415,1415,1414,1414,1414,1414,1414,1414,1415,1414,1414,1414,1414,1414,1414,1414,1414,1414,1414,1414,1414,1414,1414,1414,1414
1414,1414,1414,1414,1414,1414,1414,1414,1414,1415,1415,1414,1414,1415,1415,1415,1414,1415,1415,1415,1414,1415,1415,1415,1415,1415,1415,1414,1415,1414,1414,1414,1414,1414,1414,1414,1414,1414,1414,1414,1414,1414,1414,1414,1414,1414,1414,1414,1414,1414,1414,1414,1414
1414,1414,1414,1414,1414,1414,1414,1414,1414,1414,1414,1414,1414,1415,1415,1415,1415,1415,1415,1415,1414,1415,1415,1415,1415,1415,1415,1414,1414,1414,1414,1414,1414,1414,1414,1414,1414,1414,1414,1414,1414,1415,1414,1414,1414,1414,1414,1414,1414,1414,1414,1414,1414
1414,1414,1414,1414,1414,1414,1414,1414,1414,1414,1414,1414,1414,1415,1415,1415,1415,1415,1414,1414,1414,1415,1414,1415,1415,1415,1415,1414,1414,1414,1414,1414,1414,1414,1414,1414,1414,1414,1414,1414,1414,1414,1414,1414,1414,1414,1414,1414,1414,1414,1414,1414,1414
1414,1414,1414,1414,1414,1414,1414,1414,1414,1414,1414,1414,1414,1415,1415,1415,1415,1415,1415,1415,1414,1414,1415,1415,1415,1415,1415,1414,1414,1414,1414,1414,1414,1414,1414,1414,1414,1414,1414,1414,1414,1414,1414,1414,1414,1414,1414,1414,1414,1414,1414,1414,1414
1414,1414,1414,1414,1414,1414,1414,1414,1414,1414,1414,1414,1414,1415,1415,1415,1415,1415,1415,1415,1414,1415,1415,1415,1415,1415,1415,1414,1414,1414,1414,1414,1414,1414,1414,1414,1414,1414,1414,1414,1414,1414,1414,1414,1414,1414,1414,1414,1414,1414,1414,1414,1414
1414,1414,1414,1414,1414,1414,1414,1414,1414,1414,1414,1414,1414,1415,1415,1415,1415,1415,1415,1415,1414,1415,1415,1415,1415,1415,1415,1414,1414,1414,1414,1414,1414,1414,1414,1414,1414,1414,1414,1414,1414,1414,1414,1414,1414,1414,1414,1414,1414,1414,1414,1414,1414
1414,1414,1414,1414,1414,1414,1414,1414,1414,1414,1414,1414,1414,1415,1415,1415,1415,1415,1415,1415,1414,1415,1415,1415,1415,1415,1415,1414,1414,1414,1414,1414,1414,1414,1414,1414,1414,1414,1414,1414,1414,1414,1414,1414,1414,1414,1414,1414,1414,1414,1414,1414,1414
1414,1414,1414,1414,1414,1414,1414,1414,1414,1414,1415,1414,1414,1415,1415,1415,1415,1415,1415,1415,1414,1415,1415,1415,1415,1415,1415,1414,1414,1414,1414,1414,1414,1414,1414,1414,1414,1414,1414,1414,1414,1414,1414,1414,1414,1414,1414,1414,1414,1414,1414,1414,1414
1414,1414,1414,1414,1414,1414,1414,1414,1414,1414,1414,1414,1414,1414,1414,1414,1414,1415,1415,1415,1414,1415,1415,1414,1414,1414,1414,1414,1414,1414,1414,1414,1414,1414,1414,1414,1414,1414,1414,1414,1415,1414,1414,1414,1414,1414,1414,1414,1414,1414,1414,1414,1414
1414,1414,1414,1414,1414,1414,1414,1414,1414,1414,1414,1414,1414,1414,1414,1414,1414,1415,1415,1415,1414,1414,1414,1414,1414,1414,1414,1414,1414,1414,1414,1414,1414,1414,1414,1414,1414,1414,1414,1415,1415,1415,1415,1415,1415,1415,1415,1414,1414,1414,1414,1414,1414
1414,1414,1414,1414,1414,1414,1414,1414,1414,1414,1414,1414,1414,1414,1414,1414,1415,1415,1415,1415,1414,1414,1414,1414,1414,1414,1414,1414,1414,1414,1414,1414,1414,1414,1414,1414,1414,1414,1415,1415,1415,1415,1415,1415,1415,1415,1415,1415,1414,1414,1414,1414,1414
1414,1414,1414,1414,1414,1414,1414,1414,1414,1414,1414,1414,1414,1414,1414,1414,1415,1415,1415,1415,1414,1414,1414,1414,1414,1414,1414,1415,1414,1414,1414,1414,1414,1414,1414,1414,1414,1415,1415,1415,1415,1415,1415,1415,1415,1415,1415,1415,1415,1414,1414,1414,1414
1414,1414,1414,1414,1414,1414,1414,1414,1414,1414,1414,1414,1414,1414,1414,1414,1415,1415,1415,1414,1414,1414,1414,1414,1414,1414,1414,1414,1414,1414,1414,1414,1414,1414,1414,1414,1414,1415,1415,1415,1415,1415,1415,1415,1415,1415,1415,1415,1415,1415,1414,1414,1414
1414,1414,1414,1414,1414,1414,1414,1414,1414,1414,1414,1414,1414,1414,1414,1415,1415,1415,1415,1414,1414,1414,1414,1414,1414,1414,1414,1414,1414,1414,1414,1414,1414,1414,1414,1414,1415,1415,1415,1415,1415,1415,1415,1415,1415,1415,1415,1415,1415,1415,1415,1414,1414
1414,1414,1414,1414,1415,1414,1414,1415,1415,1415,1414,1414,1414,1414,1414,1415,1415,1415,1415,1414,1414,1414,1414,1414,1414,1414,1414,1414,1414,1414,1414,1414,1414,1414,1414,1414,1415,1415,1415,1415,1415,1415,1415,1415,1415,1415,1415,1415,1415,1415,1415,1414,1414
1414,1414,1414,1414,1414,1414,1414,1414,1415,1414,1414,1414,1414,1414,1415,1415,1415,1415,1415,1414,1414,1414,1414,1414,1414,1414,1414,1414,1414,1414,1414,1414,1414,1414,1415,1415,1415,1415,1415,1415,1415,1415,1415,1415,1415,1415,1415,1415,1415,1415,1415,1414,1414
1414,1414,1414,1414,1414,1414,1414,1414,1414,1414,1414,1414,1414,1414,1415,1415,1415,1415,1415,1414,1414,1414,1414,1414,1414,1414,1414,1414,1414,1414,1414,1414,1414,1414,1415,1415,1415,1415,1415,1415,1414,1414,1414,1414,1414,1415,1415,1415,1415,1415,1415,1414,1414
1414,1414,1414,1414,1414,1414,1414,1414,1414,1414,1414,1414,1415,1415,1415,1415,1415,1415,1414,1414,1414,1414,1414,1414,1414,1414,1414,1414,1414,1414,1414,1414,1414,1414,1415,1415,1415,1415,1415,1415,1414,1414,1414,1414,1414,1415,1415,1415,1415,1415,1415,1414,1414
1414,1414,1414,1414,1414,1414,1414,1414,1414,1414,1414,1415,1415,1415,1414,1415,1415,1415,1415,1414,1414,1414,1414,1414,1414,1414,1414,1414,1414,1414,1414,1414,1414,1414,1415,1415,1415,1415,1415,1415,1414,1414,1414,1414,1414,1415,1415,1415,1415,1415,1415,1414,1414
1414,1414,1415,1414,1414,1414,1414,1414,1414,1414,1415,1415,1415,1415,1414,1415,1415,1415,1415,1414,1414,1414,1414,1414,1414,1414,1414,1414,1414,1414,1414,1414,1414,1414,1415,1415,1415,1415,1415,1415,1415,1415,1414,1415,1415,1415,1415,1415,1415,1415,1415,1414,1414
1414,1414,1414,1414,1414,1414,1414,1414,1414,1415,1415,1415,1414,1414,1414,1414,1415,1415,1415,1414,1414,1414,1414,1414,1415,1415,1415,1414,1414,1414,1414,1414,1414,1414,1415,1415,1415,1415,1415,1415,1415,1415,1414,1415,1415,1415,1415,1415,1415,1415,1415,1414,1414
1414,1414,1414,1414,1414,1414,1414,1414,1415,1415,1415,1415,1414,1414,1414,1414,1415,1415,1415,1414,1414,1414,1414,1414,1414,1415,1414,1414,1414,1414,1414,1414,1414,1414,1415,1415,1415,1415,1415,1415,1415,1415,1414,1415,1415,1415,1415,1415,1415,1415,1415,1414,1414
1414,1414,1414,1414,1414,1414,1414,1415,1415,1415,1415,1414,1414,1414,1414,1414,1415,1415,1415,1414,1414,1414,1414,1414,1414,1414,1414,1414,1414,1414,1414,1414,1414,1414,1415,1415,1415,1415,1415,1415,1415,1415,1414,1415,1415,1415,1415,1415,1415,1415,1414,1414,1414
1414,1414,1414,1414,1414,1414,1414,1415,1415,1415,1414,1414,1414,1414,1414,1414,1414,1415,1415,1414,1414,1414,1414,1414,1414,1414,1414,1414,1414,1414,1414,1414,1414,1414,1414,1415,1415,1415,1415,1415,1415,1415,1414,1415,1415,1415,1415,1415,1415,1414,1414,1414,1414
1414,1414,1414,1414,1415,1414,1415,1415,1415,1414,1414,1414,1414,1414,1414,1414,1414,1415,1415,1414,1414,1414,1414,1414,1414,1414,1414,1414,1414,1414,1414,1414,1414,1414,1414,1414,1415,1415,1415,1415,1415,1415,1414,1415,1415,1415,1415,1415,1415,1414,1414,1414,1414
1414,1414,1414,1414,1414,1414,1415,1415,1415,1414,1414,1414,1414,1414,1414,1414,1414,1415,1415,1415,1415,1414,1414,1414,1414,1414,1414,1414,1414,1414,1414,1414,1414,1414,1414,1414,1414,1414,1415,1415,1415,1415,1414,1415,1415,1415,1415,1415,1415,1414,1414,1414,1414
1414,1414,1414,1414,1414,1415,1415,1415,1414,1414,1414,1414,1414,1414,1414,1414,1414,1415,1415,1415,1415,1414,1414,1414,1414,1414,1414,1414,1414,1414,1414,1414,1414,1414,1414,1414,1414,1414,1414,1414,1415,1415,1414,1415,1415,1415,1414,1414,1414,1414,1414,1414,1414
1414,1414,1414,1414,1414,1415,1415,1415,1414,1414,1414,1414,1414,1414,1414,1414,1414,1415,1415,1415,1415,1414,1414,1414,1414,1414,1414,1414,1414,1414,1414,1414,1414,1414,1414,1414,1414,1414,1414,1414,1414,1415,1414,1415,1414,1414,1414,1414,1414,1414,1414,1414,1414
1414,1414,1414,1414,1414,1415,1415,1414,1414,1414,1414,1414,1414,1414,1414,1414,1414,1415,1415,1415,1415,1414,1415,1415,1415,1414,1414,1414,1414,1414,1415,1414,1414,1414,1414,1414,1414,1414,1414,1414,1414,1414,1414,1414,1414,1414,1414,1414,1414,1414,1414,1414,1414
1414,1414,1414,1414,1414,1415,1415,1414,1414,1414,1414,1415,1415,1415,1414,1414,1414,1414,1415,1415,1415,1414,1414,1415,1414,1414,1414,1414,1414,1414,1414,1414,1415,1414,1414,1414,1415,1414,1414,1414,1414,1414,1414,1414,1414,1414,1414,1414,1414,1414,1414,1414,1414
1414,1414,1414,1414,1415,1415,1414,1414,1414,1414,1414,1414,1415,1414,1414,1414,1414,1414,1415,1415,1415,1414,1414,1414,1414,1414,1415,1414,1414,1414,1414,1414,1414,1414,1414,1414,1414,1414,1414,1414,1414,1414,1414,1414,1414,1414,1414,1414,1414,1414,1414,1414,1414
1414,1414,1414,1414,1415,1415,1414,1414,1414,1414,1414,1414,1414,1414,1414,1414,1414,1414,1415,1415,1415,1415,1414,1414,1414,1414,1414,1414,1414,1414,1414,1414,1414,1414,1414,1414,1414,1414,1414,1414,1414,1415,1414,1414,1414,1414,1414,1414,1414,1414,1415,1414,1414
1414,1414,1415,1414,1415,1415,1414,1414,1414,1414,1414,1414,1414,1414,1414,1414,1414,1414,1415,1415,1415,1415,1414,1414,1414,1414,1414,1414,1414,1414,1414,1415,1415,1414,1414,1414,1414,1414,1414,1414,1414,1414,1414,1414,1415,1414,1414,1414,1414,1414,1414,1414,1414
1414,1414,1414,1414,1415,1415,1415,1414,1414,1414,1414,1414,1414,1414,1414,1414,1414,1414,1414,1415,1415,1415,1414,1414,1414,1414,1414,1414,1414,1414,1414,1414,1414,1414,1414,1414,1414,1414,1414,1414,1414,1414,1414,1414,1414,1414,1414,1414,1414,1414,1414,1414,1414
1414,1414,1414,1414,1415,1414,1415,1414,1414,1414,1414,1414,1414,1414,1414,1414,1414,1414,1414,1415,1415,1415,1414,1414,1414,1414,1414,1414,1414,1414,1414,1414,1414,1414,1414,1414,1415,1414,1414,1414,1415,1414,1414,1414,1414,1414,1414,1415,1415,1414,1414,1414,1414
1414,1414,1414,1414,1415,1414,1415,1414,1414,1414,1414,1414,1414,1414,1414,1415,1414,1414,1414,1415,1415,1415,1414,1414,1414,1414,1414,1414,1414,1414,1414,1414,1414,1414,1414,1414,1414,1414,1414,1414,1414,1414,1414,1414,1415,1414,1414,1414,1414,1414,1414,1414,1415
1414,1414,1414,1414,1415,1414,1415,1414,1414,1414,1414,1414,1414,1414,1414,1414,1414,1414,1415,1415,1415,1415,1415,1415,1415,1414,1414,1414,1414,1414,1414,1414,1414,1414,1414,1414,1414,1414,1414,1414,1414,1414,1414,1414,1414,1414,1414,1414,1414,1414,1414,1414,1414
1414,1414,1414,1414,1414,1414,1415,1414,1414,1414,1415,1415,1415,1414,1414,1414,1414,1414,1414,1414,1414,1414,1414,1414,1414,1414,1414,1414,1414,1414,1414,1414,1414,1414,1414,1414,1415,1415,1414,1414,1414,1414,1414,1414,1414,1414,1414,1414,1414,1414,1414,1414,1414
1414,1414,1414,1414,1415,1414,1415,1415,1414,1414,1414,1415,1414,1414,1414,1414,1414,1414,1415,1415,1415,1415,1415,1415,1415,1414,1414,1414,1414,1414,1414,1414,1414,1415,1414,1414,1414,1414,1414,1414,1414,1414,1414,1414,1414,1414,1414,1414,1414,1414,1414,1414,1414
1414,1414,1415,1414,1415,1414,1415,1415,1414,1414,1414,1414,1414,1414,1414,1414,1414,1414,1414,1415,1415,1415,1415,1414,1414,1414,1414,1414,1414,1414,1414,1414,1414,1414,1414,1414,1414,1414,1414,1414,1414,1414,1414,1414,1415,1414,1414,1414,1414,1415,1415,1414,1414
1414,1414,1414,1414,1415,1414,1415,1414,1414,1414,1414,1414,1414,1414,1414,1414,1414,1414,1414,1415,1415,1415,1415,1414,1414,1414,1414,1414,1414,1414,1414,1414,1414,1414,1414,1414,1414,1414,1414,1414,1414,1414,1414,1414,1414,1414,1414,1414,1414,1414,1414,1414,1414
1414,1414,1414,1414,1415,1414,1415,1414,1415,1414,1414,1414,1414,1414,1414,1414,1414,1414,1414,1415,1415,1415,1415,1414,1414,1414,1414,1414,1414,1414,1414,1414,1414,1414,1414,1414,1414,1414,1414,1414,1414,1414,1414,1414,1414,1414,1414,1414,1414,1414,1414,1414,1414
1414,1414,1414,1414,1415,1414,1414,1414,1414,1414,1414,1414,1414,1414,1414,1414,1414,1414,1414,1415,1415,1415,1415,1414,1414,1414,1414,1414,1414,1414,1414,1414,1414,1414,1414,1414,1414,1414,1414,1414,1414,1414,1414,1414,1414,1414,1414,1414,1414,1414,1414,1414,1414
1414,1414,1414,1415,1415,1414,1414,1414,1414,1414,1414,1414,1414,1414,1414,1414,1414,1414,1415,1415,1415,1415,1415,1414,1414,1414,1414,1414,1414,1414,1414,1414,1414,1414,1414,1414,1414,1414,1414,1414,1414,1414,1414,1414,1414,1414,1414,1414,1414,1414,1414,1414,1414
1414,1414,1414,1415,1415,1414,1414,1414,1414,1414,1414,1414,1414,1414,1414,1414,1414,1414,1414,1415,1415,1415,1415,1414,1414,1414,1414,1414,1414,1414,1414,1414,1414,1414,1414,1414,1414,1414,1414,1414,1414,1414,1414,1414,1414,1414,1414,1414,1414,1414,1414,1414,1414
1414,1414,1414,1415,1415,1414,1414,1414,1414,1414,1414,1414,1414,1414,1414,1414,1414,1414,1414,1414,1415,1415,1415,1414,1414,1414,1414,1414,1414,1414,1414,1414,1414,1414,1414,1414,1414,1414,1414,1414,1414,1414,1414,1414,1414,1414,1414,1414,1414,1414,1414,1414,1414
1414,1414,1414,1415,1414,1414,1414,1414,1414,1414,1414,1414,1414,1414,1414,1414,1414,1414,1414,1414,1415,1415,1415,1414,1414,1414,1414,1414,1414,1414,1414,1414,1414,1414,1414,1414,1414,1414,1414,1414,1414,1414,1414,1414,1414,1414,1414,1414,1414,1414,1414,1414,1414
1414,1415,1414,1415,1414,1414,1414,1414,1414,1414,1414,1414,1415,1414,1414,1414,1414,1414,1414,1414,1415,1415,1415,1414,1414,1414,1414,1414,1414,1414,1415,1415,1415,1414,1414,1414,1414,1414,1414,1414,1415,1414,1414,1414,1414,1414,1414,1414,1414,1414,1414,1414,1414
1414,1414,1415,1415,1414,1414,1414,1414,1414,1414,1414,1414,1414,1414,1414,1414,1414,1414,1414,1414,1415,1415,1415,1414,1414,1414,1414,1414,1414,1414,1414,1415,1414,1414,1414,1414,1414,1414,1414,1414,1414,1414,1414,1414,1415,1415,1414,1414,1414,1414,1414,1414,1414
1414,1414,1415,1414,1414,1414,1414,1414,1414,1414,1414,1414,1414,1414,1414,1414,1414,1414,1414,1414,1414,1415,1415,1414,1414,1414,1414,1414,1414,1414,1414,1414,1414,1414,1414,1414,1414,1414,1414,1414,1414,1414,1414,1414,1414,1414,1414,1414,1414,1414,1414,1414,1414
1414,1414,1415,1414,1414,1414,1415,1415,1415,1414,1414,1414,1414,1414,1414,1414,1414,1414,1414,1414,1414,1415,1415,1415,1414,1414,1414,1414,1414,1414,1414,1414,1414,1414,1414,1414,1415,1414,1414,1414,1414,1414,1414,1414,1414,1414,1414,1414,1414,1414,1414,1414,1414
1414,1415,1415,1414,1414,1414,1414,1414,1414,1414,1414,1414,1414,1414,1414,1414,1414,1414,1414,1414,1414,1415,1415,1415,1414,1414,1414,1414,1414,1414,1414,1414,1414,1415,1414,1414,1414,1414,1414,1414,1414,1414,1414,1414,1414,1414,1414,1414,1414,1414,1414,1414,1414
1414,1415,1415,1414,1414,1414,1414,1414,1414,1414,1414,1414,1414,1414,1414,1414,1414,1414,1414,1414,1414,1415,1415,1415,1414,1414,1414,1414,1414,1414,1414,1414,1414,1414,1414,1414,1414,1414,1414,1414,1414,1415,1415,1415,1414,1414,1414,1415,1414,1414,1414,1414,1414
1415,1415,1414,1414,1414,1414,1414,1415,1414,1414,1414,1414,1414,1414,1414,1414,1414,1414,1414,1414,1414,1415,1415,1415,1414,1414,1414,1414,1414,1414,1414,1414,1414,1414,1414,1414,1414,1414,1414,1415,1414,1414,1415,1414,1414,1415,1414,1414,1414,1414,1414,1414,1414
1415,1414,1414,1414,1414,1414,1414,1414,1414,1414,1414,1415,1415,1415,1414,1414,1414,1414,1414,1414,1414,1415,1415,1415,1414,1414,1414,1414,1414,1414,1414,1415,1414,1414,1414,1414,1414,1414,1414,1414,1414,1414,1414,1414,1414,1414,1414,1414,1414,1414,1414,1414,1414
1415,1414,1414,1414,1414,1414,1414,1414,1414,1414,1414,1414,1415,1414,1414,1414,1414,1414,1414,1414,1414,1415,1415,1415,1415,1414,1414,1414,1414,1414,1414,1414,1414,1414,1415,1414,1414,1414,1414,1414,1414,1414,1414,1414,1414,1414,1414,1414,1414,1414,1414,1414,1414
1414,1414,1414,1414,1414,1414,1414,1414,1414,1414,1414,1414,1414,1414,1414,1414,1414,1414,1414,1414,1414,1415,1415,1415,1415,1414,1414,1414,1414,1414,1414,1414,1414,1414,1414,1414,1414,1414,1414,1414,1414,1414,1414,1414,1414,1414,1414,1414,1414,1414,1414,1414,1414
1414,1414,1414,1414,1414,1414,1414,1414,1414,1414,1414,1414,1414,1414,1414,1414,1414,1414,1414,1414,1414,1414,1415,1415,1415,1414,1414,1414,1414,1414,1415,1415,1415,1414,1414,1414,1414,1414,1414,1414,1414,1414,1414,1414,1414,1414,1414,1414,1415,1415,1414,1414,1414
1414,1414,1414,1414,1414,1414,1414,1414,1414,1414,1414,1414,1414,1414,1414,1414,1414,1414,1414,1414,1414,1414,1415,1415,1415,1414,1414,1414,1414,1414,1414,1415,1414,1414,1414,1414,1414,1414,1414,1414,1414,1414,1414,1415,1414,1414,1414,1414,1414,1414,1414,1414,1414
1414,1414,1414,1414,1414,1414,1415,1415,1415,1414,1414,1414,1414,1414,1414,1414,1414,1414,1414,1414,1414,1414,1415,1415,1415,1415,1414,1414,1414,1414,1414,1414,1414,1414,1414,1414,1414,1414,1414,1414,1414,1414,1414,1414,1414,1414,1414,1414,1414,1414,1414,1414,1414
1414,1414,1414,1414,1414,1414,1414,1415,1414,1414,1414,1414,1414,1414,1414,1414,1414,1414,1414,1414,1414,1414,1415,1415,1415,1415,1414,1414,1414,1414,1414,1415,1414,1414,1414,1414,1414,1414,1414,1414,1414,1414,1414,1414,1414,1414,1415,1414,1414,1415,1415,1415,1414
1414,1414,1415,1414,1414,1414,1414,1414,1414,1414,1414,1414,1414,1414,1414,1414,1414,1414,1414,1414,1414,1414,1415,1415,1415,1415,1414,1414,1414,1414,1414,1414,1414,1414,1414,1414,1414,1414,1414,1414,1414,1414,1414,1415,1414,1414,1414,1414,1414,1415,1415,1415,1414
1414,1414,1414,1414,1414,1414,1414,1414,1414,1414,1414,1414,1414,1414,1414,1414,1414,1414,1414,1414,1414,1414,1415,1415,1415,1415,1414,1414,1414,1414,1414,1414,1414,1414,1414,1414,1414,1414,1414,1414,1414,1414,1414,1414,1414,1414,1414,1414,1414,1415,1415,1415,1414
1414,1414,1414,1414,1414,1414,1414,1414,1414,1414,1415,1414,1414,1414,1414,1414,1414,1414,1414,1414,1414,1414,1415,1415,1415,1415,1414,1414,1414,1414,1414,1414,1414,1414,1414,1414,1414,1414,1414,1414,1414,1415,1414,1414,1414,1414,1415,1415,1414,1415,1415,1415,1414
1414,1414,1414,1414,1414,1414,1414,1414,1414,1414,1414,1414,1414,1414,1414,1414,1414,1414,1414,1414,1414,1414,1415,1415,1415,1415,1414,1414,1414,1414,1414,1414,1414,1414,1414,1414,1414,1414,1414,1414,1414,1414,1414,1414,1414,1414,1415,1415,1415,1415,1415,1415,1414
1415,1414,1414,1414,1414,1414,1414,1414,1414,1414,1414,1414,1414,1414,1414,1414,1414,1414,1414,1414,1414,1414,1414,1415,1415,1415,1415,1414,1414,1414,1414,1414,1414,1414,1414,1414,1414,1414,1414,1414,1414,1414,1414,1414,1414,1414,1414,1414,1414,1414,1414,1414,1414
1414,1414,1414,1414,1414,1414,1414,1414,1414,1414,1414,1414,1414,1414,1414,1414,1414,1414,1414,1414,1414,1414,1414,1414,1415,1415,1415,1415,1414,1414,1414,1414,1414,1414,1414,1414,1414,1414,1414,1414,1414,1414,1414,1415,1415,1414,1414,1414,1414,1414,1414,1414,1414
1414,1414,1414,1414,1414,1415,1415,1415,1414,1414,1414,1414,1414,1414,1414,1414,1414,1414,1414,1414,1414,1414,1414,1414,1415,1415,1415,1415,1414,1414,1414,1414,1415,1415,1415,1414,1414,1414,1414,1414,1414,1415,1415,1415,1414,1414,1414,1414,1414,1414,1414,1414,1414
1414,1414,1414,1414,1414,1414,1415,1414,1414,1414,1414,1414,1414,1414,1415,1414,1415,1414,1414,1414,1414,1414,1414,1414,1415,1415,1415,1415,1414,1414,1414,1414,1414,1415,1414,1414,1414,1414,1414,1414,1414,1414,1414,1414,1414,1415,1414,1414,1414,1414,1414,1414,1414
1414,1414,1414,1414,1414,1414,1414,1414,1414,1414,1414,1414,1414,1414,1414,1414,1414,1414,1414,1414,1414,1414,1414,1414,1415,1415,1415,1415,1415,1414,1414,1414,1414,1414,1414,1414,1414,1414,1415,1414,1414,1414,1414,1414,1414,1414,1414,1414,1414,1414,1414,1414,1414
1414,1414,1414,1414,1414,1414,1415,1414,1414,1414,1414,1414,1414,1414,1414,1414,1414,1414,1414,1414,1414,1414,1414,1414,1415,1415,1415,1415,1415,1414,1414,1414,1414,1414,1414,1414,1414,1414,1414,1414,1414,1414,1414,1414,1414,1414,1414,1414,1414,1414,1414,1414,1414
1414,1415,1415,1415,1414,1414,1414,1414,1414,1414,1414,1414,1414,1414,1414,1414,1414,1414,1414,1414,1414,1414,1414,1414,1414,1415,1415,1415,1415,1415,1414,1414,1414,1414,1414,1414,1414,1414,1414,1414,1414,1414,1414,1414,1414,1414,1414,1414,1415,1415,1415,1414,1414
1414,1414,1414,1414,1414,1414,1414,1414,1414,1414,1414,1414,1414,1414,1414,1414,1414,1414,1414,1414,1414,1414,1414,1414,1414,1415,1415,1415,1415,1415,1414,1414,1414,1414,1414,1414,1415,1415,1415,1414,1414,1414,1415,1415,1415,1414,1414,1414,1414,1415,1414,1414,1414
1414,1414,1414,1414,1414,1414,1414,1414,1414,1414,1414,1414,1414,1414,1414,1414,1414,1414,1414,1414,1414,1414,1414,1414,1414,1415,1415,1415,1415,1415,1415,1414,1414,1414,1414,1414,1414,1415,1414,1414,1414,1414,1414,1415,1414,1414,1414,1414,1414,1414,1414,1414,1414
1415,1415,1415,1415,1415,1415,1415,1415,1415,1415,1414,1414,1414,1415,1415,1415,1415,1415,1415,1415,1415,1415,1415,1415,1415,1415,1415,1415,1415,1415,1415,1414,1414,1414,1414,1414,1414,1414,1414,1414,1414,1414,1414,1414,1414,1414,1414,1414,1414,1414,1414,1414,1414
1414,1414,1414,1414,1414,1414,1414,1414,1414,1414,1414,1414,1414,1414,1414,1414,1414,1414,1414,1414,1414,1414,1414,1414,1414,1415,1415,1415,1415,1415,1415,1414,1414,1414,1414,1414,1414,1414,1414,1414,1414,1414,1414,1414,1414,1415,1414,1414,1414,1414,1414,1414,1414
1414,1414,1414,1414,1414,1414,1414,1414,1414,1414,1414,1414,1414,1414,1414,1415,1415,1415,1414,1414,1414,1414,1414,1414,1414,1415,1415,1415,1415,1415,1415,1415,1415,1414,1414,1414,1414,1414,1414,1415,1415,1415,1414,1414,1414,1414,1414,1414,1414,1414,1414,1414,1414
1414,1414,1414,1414,1414,1414,1414,1414,1414,1414,1414,1414,1414,1414,1414,1414,1415,1414,1414,1414,1414,1414,1414,1414,1414,1414,1415,1415,1415,1415,1415,1415,1415,1415,1415,1414,1414,1414,1414,1414,1415,1414,1414,1414,1414,1414,1414,1414,1414,1415,1415,1415,1414
1414,1414,1415,1415,1415,1414,1414,1414,1414,1414,1414,1414,1414,1414,1414,1414,1414,1414,1414,1414,1414,1414,1414,1414,1414,1414,1415,1415,1415,1415,1415,1415,1415,1415,1415,1415,1414,1414,1414,1414,1414,1414,1414,1414,1414,1414,1414,1414,1414,1414,1415,1414,1414
1414,1414,1414,1415,1414,1414,1414,1414,1414,1414,1414,1414,1414,1414,1414,1414,1414,1414,1414,1414,1414,1414,1414,1414,1414,1414,1414,1415,1415,1415,1415,1415,1415,1415,1415,1415,1414,1414,1414,1414,1414,1414,1414,1414,1415,1415,1415,1414,1414,1414,1414,1414,1414
1414,1414,1414,1414,1414,1414,1414,1414,1415,1414,1414,1414,1414,1414,1414,1414,1414,1414,1414,1414,1414,1414,1414,1414,1414,1414,1414,1414,1415,1415,1415,1415,1415,1415,1415,1415,1415,1414,1414,1414,1414,1414,1414,1414,1414,1415,1414,1414,1414,1414,1414,1414,1414
1414,1414,1414,1414,1414,1414,1414,1414,1414,1414,1414,1414,1414,1414,1414,1414,1414,1414,1414,1414,1414,1414,1414,1414,1414,1414,1414,1414,1415,1415,1415,1415,1415,1415,1415,1415,1415,1415,1414,1414,1414,1415,1415,1415,1414,1414,1414,1414,1414,1414,1414,1414,1414
1414,1414,1414,1414,1414,1414,1414,1414,1414,1414,1414,1414,1414,1414,1414,1414,1414,1414,1414,1414,1414,1414,1414,1414,1414,1414,1414,1414,1415,1415,1415,1415,1415,1415,1415,1415,1415,1415,1414,1414,1414,1414,1415,1414,1414,1414,1414,1415,1415,1415,1414,1414,1414
1414,1414,1414,1414,1414,1414,1414,1414,1414,1414,1414,1414,1414,1414,1414,1414,1414,1415,1414,1414,1414,1414,1414,1414,1414,1414,1414,1414,1415,1415,1415,1415,1415,1415,1415,1415,1415,1415,1415,1414,1414,1414,1414,1414,1414,1414,1414,1414,1415,1414,1414,1415,1415
1414,1414,1414,1414,1414,1414,1414,1414,1414,1414,1414,1414,1414,1414,1414,1414,1414,1414,1414,1414,1414,1414,1414,1414,1414,1414,1414,1414,1414,1415,1415,1415,1415,1415,1415,1415,1415,1415,1415,1414,1414,1414,1414,1414,1414,1414,1414,1414,1414,1414,1414,1414,1415
1414,1414,1414,1414,1414,1414,1414,1414,1414,1414,1414,1414,1414,1414,1414,1414,1414,1414,1414,1414,1414,1414,1414,1414,1414,1414,1414,1414,1414,1414,1415,1415,1415,1415,1415,1415,1415,1415,1415,1414,1414,1414,1414,1414,1414,1414,1414,1414,1414,1414,1414,1414,1414
1414,1414,1414,1414,1414,1414,1414,1414,1414,1414,1414,1414,1414,1414,1414,1414,1414,1414,1414,1414,1414,1415,1415,1415,1414,1414,1414,1414,1414,1414,1414,1415,1415,1415,1415,1415,1415,1415,1415,1415,1414,1414,1414,1414,1414,1414,1414,1414,1414,1414,1414,1414,1414
1414,1414,1414,1414,1414,1414,1414,1414,1414,1414,1414,1415,1415,1415,1414,1414,1414,1414,1414,1414,1414,1414,1414,1414,1414,1414,1414,1414,1414,1414,1414,1414,1415,1415,1415,1415,1415,1415,1415,1415,1414,1414,1414,1414,1415,1415,1415,1414,1414,1414,1414,1414,1414
1414,1414,1414,1414,1414,1414,1414,1414,1414,1414,1414,1414,1415,1414,1414,1414,1414,1414,1414,1414,1414,1414,1414,1414,1414,1414,1414,1414,1414,1414,1414,1414,1414,1415,1415,1415,1415,1415,1415,1415,1414,1414,1414,1414,1414,1415,1414,1414,1414,1414,1414,1414,1414
1414,1414,1414,1414,1414,1414,1414,1414,1414,1414,1414,1414,1414,1414,1414,1414,1414,1414,1414,1414,1414,1414,1414,1414,1414,1414,1414,1414,1414,1414,1414,1414,1414,1415,1415,1415,1415,1415,1415,1415,1415,1414,1414,1414,1414,1414,1414,1414,1414,1415,1415,1415,1414
1414,1414,1414,1414,1414,1414,1414,1414,1414,1414,1414,1414,1414,1414,1414,1414,1414,1414,1414,1414,1414,1414,1414,1414,1414,1414,1414,1414,1414,1414,1414,1414,1414,1414,1415,1415,1415,1415,1415,1415,1415,1414,1414,1414,1414,1414,1414,1414,1414,1414,1415,1414,1414
1414,1414,1415,1414,1414,1414,1414,1414,1414,1414,1414,1414,1414,1414,1414,1414,1414,1414,1414,1414,1414,1414,1414,1414,1414,1414,1414,1414,1414,1414,1414,1414,1414,1414,1414,1415,1415,1415,1415,1415,1415,1414,1414,1414,1414,1414,1414,1414,1414,1414,1414,1414,1414
1414,1414,1414,1414,1414,1414,1414,1414,1414,1414,1414,1414,1414,1414,1414,1414,1414,1414,1414,1415,1415,1415,1414,1414,1414,1414,1414,1414,1414,1414,1414,1414,1414,1414,1414,1415,1415,1415,1415,1415,1415,1415,1414,1414,1414,1414,1414,1414,1414,1414,1414,1414,1414
1414,1414,1414,1414,1414,1414,1414,1414,1414,1414,1414,1414,1414,1414,1414,1414,1414,1414,1414,1414,1415,1414,1414,1414,1414,1414,1414,1414,1414,1414,1414,1414,1414,1414,1414,1415,1415,1415,1415,1415,1415,1415,1414,1414,1414,1414,1414,1414,1414,1414,1414,1414,1414
1414,1414,1414,1414,1414,1414,1414,1414,1414,1414,1414,1414,1414,1414,1414,1414,1414,1414,1414,1414,1414,1414,1414,1414,1414,1414,1414,1414,1414,1414,1414,1414,1414,1414,1414,1414,1415,1415,1415,1415,1415,1415,1414,1414,1414,1414,1414,1414,1414,1414,1414,1414,1414
1414,1414,1414,1414,1414,1414,1414,1414,1414,1414,1414,1414,1414,1414,1414,1414,1414,1414,1414,1414,1414,1414,1414,1414,1414,1414,1414,1414,1414,1414,1414,1414,1414,1414,1414,1414,1415,1415,1415,1415,1415,1415,1415,1414,1414,1414,1414,1414,1414,1414,1414,1414,1414
1414,1414,1414,1414,1960,1960,1960,1960,1960,1960,1960,1414,1414,1414,1414,1414,1414,1414,1414,1415,1415,1415,1415,1415,1415,1415,1415,1415,1415,1415,1415,1415,1414,1414,1414,1414,1415,1415,1415,1415,1415,1415,1415,1415,1415,1415,1415,1415,1415,1415,1415,1415,1415
